0,-53,144,-109,41,159.3869844560481,56,103,61.46778333380981
1,-53,144,-109,41,159.3869844560481,56,103,61.46778333380981
2,-53,144,-109,41,159.3869844560481,56,103,61.46778333380981
3,-53,144,-109,41,159.3869844560481,56,103,61.46778333380981
4,-53,144,-109,41,159.3869844560481,56,103,61.46778333380981
5,-53,144,-109,41,159.3869844560481,56,103,61.46778333380981
6,-53,144,-109,41,159.3869844560481,56,103,61.46778333380981
7,-53,144,-109,41,159.3869844560481,56,103,61.46778333380981
8,-53,144,-109,41,159.3869844560481,56,103,61.46778333380981
9,-53,144,-109,41,159.3869844560481,56,103,61.46778333380981
10,-53,144,-109,41,159.3869844560481,56,103,61.46778333380981
11,-53,144,-109,41,159.3869844560481,56,103,61.46778333380981
12,-53,144,-109,41,159.3869844560481,56,103,61.46778333380981
13,-53,144,-109,41,159.3869844560481,56,103,61.46778333380981
14,-53,144,-109,41,159.3869844560481,56,103,61.46778333380981
15,-53,144,-109,41,159.3869844560481,56,103,61.46778333380981
16,-53,144,-109,41,159.3869844560481,56,103,61.46778333380981
17,-53,144,-109,41,159.3869844560481,56,103,61.46778333380981
18,-53,144,-109,41,159.3869844560481,56,103,61.46778333380981
19,-53,144,-109,41,159.3869844560481,56,103,61.46778333380981
20,-53,144,-109,41,159.3869844560481,56,103,61.46778333380981
21,-53,144,-109,41,159.3869844560481,56,103,61.46778333380981
22,-53,144,-109,41,159.3869844560481,56,103,61.46778333380981
23,-53,144,-109,41,159.3869844560481,56,103,61.46778333380981
24,-53,144,-109,41,159.3869844560481,56,103,61.46778333380981
25,-53,144,-109,41,159.3869844560481,56,103,61.46778333380981
26,-53,144,-109,41,159.3869844560481,56,103,61.46778333380981
27,-53,144,-109,41,159.3869844560481,56,103,61.46778333380981
28,-53,144,-109,41,159.3869844560481,56,103,61.46778333380981
29,-53,144,-109,41,159.3869844560481,56,103,61.46778333380981
30,-52,144,-109,42,158.92788496758592,57,102,60.80274793554818
31,-49,144,-109,43,158.4716029498293,60,101,59.28740043508163
32,-47,144,-108,44,157.8342615569638,61,100,58.61703451417405
33,-44,145,-107,47,156.28700653854642,63,98,57.264994095492916
34,-41,145,-107,48,155.83968458017517,66,97,55.768359169346056
35,-39,145,-106,49,155.19118883249348,67,96,55.088381774933886
36,-37,146,-105,51,154.094084986555,68,95,54.40552086471004
37,-34,146,-104,53,152.99649805956707,70,93,53.031860172105006
38,-32,146,-104,54,152.56085913769832,72,92,51.95315739472267
39,-30,146,-103,55,151.89923323386185,73,91,51.26368788766131
40,-29,147,-103,56,151.46812967385023,74,91,50.88264139707602
41,-26,147,-102,58,150.37682993012544,76,89,49.505097369511944
42,-25,147,-101,58,150.13366089402126,76,89,49.505097369511944
43,-22,147,-100,60,149.0368169925774,78,87,48.12231564678913
44,-19,147,-99,62,147.94319358195528,80,85,46.73588443832634
45,-17,147,-99,63,147.52937543285395,82,84,45.69045302422564
46,-15,147,-98,64,146.85356929080396,83,83,45.0001731700202
47,-12,147,-97,66,145.76870550938645,85,81,43.61981378466591
48,-10,147,-96,67,145.0887281149743,86,80,42.93013455104021
49,-5,147,-93,70,143.0322065121454,88,77,41.1860836583206
50,-4,147,-93,71,142.64095567307385,89,76,40.49524897052845
51,-1,147,-92,73,141.56930890994872,91,74,39.11770494296437
52,2,147,-90,75,140.1949684071145,92,72,38.04718894531772
53,4,147,-89,76,139.50544370955234,93,71,37.35973700700693
54,6,147,-88,77,138.8146090217602,94,70,36.674490800637
55,8,146,-87,78,138.12266198682954,95,68,35.59482547533036
56,11,146,-86,80,137.07055812904056,97,66,34.23198717069434
57,13,146,-84,81,136.04215019448196,97,65,33.82629192878782
58,14,146,-84,82,135.69079936426604,98,64,33.14712338927684
59,15,146,-83,82,135.34776374341433,98,64,33.14712338927684
60,16,146,-83,83,135.0005195100606,99,63,32.47131724722682
61,16,146,-83,83,135.0005195100606,99,63,32.47131724722682
62,16,146,-83,83,135.0005195100606,99,63,32.47131724722682
63,16,146,-83,83,135.0005195100606,99,63,32.47131724722682
64,16,146,-83,83,135.0005195100606,99,63,32.47131724722682
65,16,146,-83,83,135.0005195100606,99,63,32.47131724722682
66,16,146,-83,83,135.0005195100606,99,63,32.47131724722682
67,16,146,-83,83,135.0005195100606,99,63,32.47131724722682
68,16,146,-83,83,135.0005195100606,99,63,32.47131724722682
69,17,146,-82,84,134.31023965585516,99,62,32.057499098125504
70,19,146,-81,85,133.6201601247063,100,61,31.383311825866343
71,21,146,-79,86,132.57123683817593,100,60,30.96387568750339
72,23,146,-78,87,131.87837703329166,101,59,30.29181266950893
73,26,146,-76,89,130.49559531056886,102,57,29.197598404492215
74,29,145,-74,90,129.4283002630389,103,55,28.101459446218957
75,32,145,-72,92,128.0475352853581,104,53,27.004194620513708
76,34,145,-71,93,127.36008334704732,105,52,26.346467444338174
77,37,145,-69,95,125.9919811013071,106,50,25.253260574369772
78,39,145,-67,96,124.9123109051469,106,49,24.809503847587308
79,42,145,-65,97,123.82663826882822,107,48,24.161008099905626
80,44,145,-63,98,122.73569858458788,107,47,23.713686141534367
81,47,145,-61,100,121.38365816590672,108,45,22.619951994317535
82,48,145,-60,100,120.96422202754377,108,45,22.619951994317535
83,51,145,-58,102,119.62420908999574,109,43,21.52908973025149
84,53,144,-56,103,118.53290934627098,109,41,20.61370822403267
85,55,143,-55,103,118.10180578625936,110,40,19.983183421343536
86,56,143,-54,104,117.44017988242288,110,39,19.521805399885235
87,58,143,-53,105,116.783354208797,111,38,18.898319639926033
88,59,143,-52,105,116.34681378437855,111,38,18.898319639926033
89,60,143,-51,105,115.9069540335662,111,38,18.898319639926033
90,61,142,-50,106,115.25360691441017,111,36,17.969208889407945
91,62,142,-49,106,114.80985018762772,111,36,17.969208889407945
92,64,141,-48,107,114.16135443994601,112,34,16.88685610807649
93,65,141,-47,107,113.71403248157476,112,34,16.88685610807649
94,65,140,-47,107,113.71403248157476,112,33,16.41729600760235
95,65,140,-47,107,113.71403248157476,112,33,16.41729600760235
96,65,140,-47,107,113.71403248157476,112,33,16.41729600760235
97,65,140,-47,107,113.71403248157476,112,33,16.41729600760235
98,65,140,-47,107,113.71403248157476,112,33,16.41729600760235
99,65,140,-47,107,113.71403248157476,112,33,16.41729600760235
100,65,140,-47,107,113.71403248157476,112,33,16.41729600760235
101,65,140,-47,107,113.71403248157476,112,33,16.41729600760235
102,65,140,-47,107,113.71403248157476,112,33,16.41729600760235
103,65,140,-47,107,113.71403248157476,112,33,16.41729600760235
104,68,139,-45,108,112.62029833435793,113,31,15.34094979916853
105,70,138,-43,109,111.52943607029188,113,29,14.393648358241299
106,73,138,-41,110,110.44222156304191,114,28,13.799538499511918
107,75,136,-39,110,109.52215173992562,114,26,12.847754299546773
108,77,136,-37,111,108.43536610475041,114,25,12.369109124828487
109,80,135,-35,112,107.35443775845276,115,23,11.309975997158768
110,82,134,-33,112,106.41764234764274,115,22,10.830121219964632
111,84,133,-31,113,105.34129613920892,115,20,9.865844908906315
112,86,132,-29,113,104.39399469828169,115,19,9.381546262888328
113,88,132,-28,114,103.7998848395523,116,18,8.820413494805617
114,89,132,-27,114,103.32492887769446,116,18,8.820413494805617
115,92,131,-24,115,101.78857500270225,116,16,7.853343523276511
116,93,131,-23,115,101.31032233719917,116,16,7.853343523276511
117,96,130,-20,115,99.86619124894672,116,15,7.368079425523356
118,97,129,-19,115,99.38189260292873,116,14,6.881750113041841
119,98,128,-18,116,98.82075983484602,116,12,5.906163841916633
120,99,128,-17,116,98.33782286322983,116,12,5.906163841916633
121,99,128,-17,116,98.33782286322983,116,12,5.906163841916633
122,99,128,-17,116,98.33782286322983,116,12,5.906163841916633
123,99,128,-17,116,98.33782286322983,116,12,5.906163841916633
124,99,128,-17,116,98.33782286322983,116,12,5.906163841916633
125,99,128,-17,116,98.33782286322983,116,12,5.906163841916633
126,99,128,-17,116,98.33782286322983,116,12,5.906163841916633
127,99,128,-17,116,98.33782286322983,116,12,5.906163841916633
128,99,128,-17,116,98.33782286322983,116,12,5.906163841916633
129,99,128,-17,116,98.33782286322983,116,12,5.906163841916633
130,99,128,-17,116,98.33782286322983,116,12,5.906163841916633
131,99,128,-17,116,98.33782286322983,116,12,5.906163841916633
132,99,128,-17,116,98.33782286322983,116,12,5.906163841916633
133,99,128,-17,116,98.33782286322983,116,12,5.906163841916633
134,99,128,-17,116,98.33782286322983,116,12,5.906163841916633
135,99,128,-17,116,98.33782286322983,116,12,5.906163841916633
136,99,128,-17,116,98.33782286322983,116,12,5.906163841916633
137,99,128,-17,116,98.33782286322983,116,12,5.906163841916633
138,99,128,-17,116,98.33782286322983,116,12,5.906163841916633
139,99,128,-17,116,98.33782286322983,116,12,5.906163841916633
140,99,128,-17,116,98.33782286322983,116,12,5.906163841916633
141,99,128,-17,116,98.33782286322983,116,12,5.906163841916633
142,99,128,-17,116,98.33782286322983,116,12,5.906163841916633
143,99,128,-17,116,98.33782286322983,116,12,5.906163841916633
144,99,128,-17,116,98.33782286322983,116,12,5.906163841916633
145,99,128,-17,116,98.33782286322983,116,12,5.906163841916633
146,99,128,-17,116,98.33782286322983,116,12,5.906163841916633
147,99,128,-17,116,98.33782286322983,116,12,5.906163841916633
148,99,128,-17,116,98.33782286322983,116,12,5.906163841916633
149,99,128,-17,116,98.33782286322983,116,12,5.906163841916633
150,99,128,-17,116,98.33782286322983,116,12,5.906163841916633
151,99,128,-17,116,98.33782286322983,116,12,5.906163841916633
152,99,128,-17,116,98.33782286322983,116,12,5.906163841916633
153,99,128,-17,116,98.33782286322983,116,12,5.906163841916633
154,99,128,-17,116,98.33782286322983,116,12,5.906163841916633
155,99,128,-17,116,98.33782286322983,116,12,5.906163841916633
156,99,128,-17,116,98.33782286322983,116,12,5.906163841916633
157,99,128,-17,116,98.33782286322983,116,12,5.906163841916633
158,99,128,-17,116,98.33782286322983,116,12,5.906163841916633
159,99,128,-17,116,98.33782286322983,116,12,5.906163841916633
160,99,128,-17,116,98.33782286322983,116,12,5.906163841916633
161,99,128,-17,116,98.33782286322983,116,12,5.906163841916633
162,99,128,-17,116,98.33782286322983,116,12,5.906163841916633
163,99,128,-17,116,98.33782286322983,116,12,5.906163841916633
164,99,128,-17,116,98.33782286322983,116,12,5.906163841916633
165,99,128,-17,116,98.33782286322983,116,12,5.906163841916633
166,99,128,-17,116,98.33782286322983,116,12,5.906163841916633
167,99,128,-17,116,98.33782286322983,116,12,5.906163841916633
168,99,128,-17,116,98.33782286322983,116,12,5.906163841916633
169,99,128,-17,116,98.33782286322983,116,12,5.906163841916633
170,99,128,-17,116,98.33782286322983,116,12,5.906163841916633
171,99,128,-17,116,98.33782286322983,116,12,5.906163841916633
172,99,128,-17,116,98.33782286322983,116,12,5.906163841916633
173,99,128,-17,116,98.33782286322983,116,12,5.906163841916633
174,99,128,-17,116,98.33782286322983,116,12,5.906163841916633
175,99,128,-17,116,98.33782286322983,116,12,5.906163841916633
176,99,128,-17,116,98.33782286322983,116,12,5.906163841916633
177,99,128,-17,116,98.33782286322983,116,12,5.906163841916633
178,99,128,-17,116,98.33782286322983,116,12,5.906163841916633
179,99,128,-17,116,98.33782286322983,116,12,5.906163841916633
180,99,128,-17,116,98.33782286322983,116,12,5.906163841916633
181,99,128,-17,116,98.33782286322983,116,12,5.906163841916633
182,99,128,-17,116,98.33782286322983,116,12,5.906163841916633
183,99,128,-17,116,98.33782286322983,116,12,5.906163841916633
184,99,128,-17,116,98.33782286322983,116,12,5.906163841916633
185,99,128,-17,116,98.33782286322983,116,12,5.906163841916633
186,99,128,-17,116,98.33782286322983,116,12,5.906163841916633
187,99,128,-17,116,98.33782286322983,116,12,5.906163841916633
188,99,128,-17,116,98.33782286322983,116,12,5.906163841916633
189,99,128,-17,116,98.33782286322983,116,12,5.906163841916633
190,99,128,-17,116,98.33782286322983,116,12,5.906163841916633
191,99,128,-17,116,98.33782286322983,116,12,5.906163841916633
192,99,128,-17,116,98.33782286322983,116,12,5.906163841916633
193,99,128,-17,116,98.33782286322983,116,12,5.906163841916633
194,99,128,-17,116,98.33782286322983,116,12,5.906163841916633
195,99,128,-17,116,98.33782286322983,116,12,5.906163841916633
196,99,128,-17,116,98.33782286322983,116,12,5.906163841916633
197,99,128,-17,116,98.33782286322983,116,12,5.906163841916633
198,99,128,-17,116,98.33782286322983,116,12,5.906163841916633
199,99,128,-17,116,98.33782286322983,116,12,5.906163841916633
200,99,128,-17,116,98.33782286322983,116,12,5.906163841916633
201,99,128,-17,116,98.33782286322983,116,12,5.906163841916633
202,99,128,-17,116,98.33782286322983,116,12,5.906163841916633
203,99,128,-17,116,98.33782286322983,116,12,5.906163841916633
204,99,128,-17,116,98.33782286322983,116,12,5.906163841916633
205,99,128,-17,116,98.33782286322983,116,12,5.906163841916633
206,100,127,-16,116,97.85368986331692,116,11,5.4170429597639185
207,101,125,-16,116,97.85368986331692,117,9,4.398722282193202
208,102,123,-15,116,97.36842576556376,117,7,3.423884420749627
209,104,120,-13,116,96.39476871233444,117,4,1.958074964313514
210,105,118,-12,116,95.90651018195702,117,2,0.9793234229795835
211,106,116,-11,116,95.41738929980431,117,0,0.0
212,108,115,-9,117,94.3990686222336,117,-2,359.0206765770204
213,109,113,-8,117,93.91193320516838,117,-4,358.04192503568646
214,110,111,-7,117,93.42423076079002,117,-6,357.0643152564537
215,111,109,-6,117,92.93603108358668,117,-8,356.088413134872
216,112,107,-5,117,92.44740439915208,117,-10,355.11477863253543
217,113,105,-3,117,91.46915270669842,116,-12,354.0938361580834
218,113,104,-3,117,91.46915270669842,116,-13,353.60557762770594
219,113,104,-3,117,91.46915270669842,116,-13,353.60557762770594
220,113,104,-3,117,91.46915270669842,116,-13,353.60557762770594
221,113,104,-3,117,91.46915270669842,116,-13,353.60557762770594
222,113,104,-3,117,91.46915270669842,116,-13,353.60557762770594
223,113,104,-3,117,91.46915270669842,116,-13,353.60557762770594
224,113,104,-3,117,91.46915270669842,116,-13,353.60557762770594
225,113,104,-3,117,91.46915270669842,116,-13,353.60557762770594
226,113,104,-3,117,91.46915270669842,116,-13,353.60557762770594
227,113,104,-3,117,91.46915270669842,116,-13,353.60557762770594
228,113,104,-3,117,91.46915270669842,116,-13,353.60557762770594
229,113,104,-3,117,91.46915270669842,116,-13,353.60557762770594
230,113,104,-3,117,91.46915270669842,116,-13,353.60557762770594
231,113,104,-3,117,91.46915270669842,116,-13,353.60557762770594
232,113,104,-3,117,91.46915270669842,116,-13,353.60557762770594
233,113,104,-3,117,91.46915270669842,116,-13,353.60557762770594
234,113,104,-3,117,91.46915270669842,116,-13,353.60557762770594
235,113,104,-3,117,91.46915270669842,116,-13,353.60557762770594
236,113,104,-3,117,91.46915270669842,116,-13,353.60557762770594
237,113,104,-3,117,91.46915270669842,116,-13,353.60557762770594
238,113,104,-3,117,91.46915270669842,116,-13,353.60557762770594
239,113,104,-3,117,91.46915270669842,116,-13,353.60557762770594
240,113,104,-3,117,91.46915270669842,116,-13,353.60557762770594
241,113,104,-3,117,91.46915270669842,116,-13,353.60557762770594
242,113,104,-3,117,91.46915270669842,116,-13,353.60557762770594
243,113,104,-3,117,91.46915270669842,116,-13,353.60557762770594
244,113,104,-3,117,91.46915270669842,116,-13,353.60557762770594
245,113,104,-3,117,91.46915270669842,116,-13,353.60557762770594
246,113,104,-3,117,91.46915270669842,116,-13,353.60557762770594
247,113,104,-3,117,91.46915270669842,116,-13,353.60557762770594
248,113,104,-3,117,91.46915270669842,116,-13,353.60557762770594
249,113,104,-3,117,91.46915270669842,116,-13,353.60557762770594
250,113,104,-3,117,91.46915270669842,116,-13,353.60557762770594
251,113,104,-3,117,91.46915270669842,116,-13,353.60557762770594
252,113,104,-3,117,91.46915270669842,116,-13,353.60557762770594
253,113,104,-3,117,91.46915270669842,116,-13,353.60557762770594
254,113,104,-3,117,91.46915270669842,116,-13,353.60557762770594
255,113,104,-3,117,91.46915270669842,116,-13,353.60557762770594
256,113,104,-3,117,91.46915270669842,116,-13,353.60557762770594
257,113,104,-3,117,91.46915270669842,116,-13,353.60557762770594
258,113,104,-3,117,91.46915270669842,116,-13,353.60557762770594
259,113,104,-3,117,91.46915270669842,116,-13,353.60557762770594
260,113,104,-3,117,91.46915270669842,116,-13,353.60557762770594
261,113,104,-3,117,91.46915270669842,116,-13,353.60557762770594
262,113,104,-3,117,91.46915270669842,116,-13,353.60557762770594
263,113,104,-3,117,91.46915270669842,116,-13,353.60557762770594
264,113,104,-3,117,91.46915270669842,116,-13,353.60557762770594
265,113,104,-3,117,91.46915270669842,116,-13,353.60557762770594
266,113,104,-3,117,91.46915270669842,116,-13,353.60557762770594
267,113,104,-3,117,91.46915270669842,116,-13,353.60557762770594
268,113,104,-3,117,91.46915270669842,116,-13,353.60557762770594
269,113,104,-3,117,91.46915270669842,116,-13,353.60557762770594
270,113,104,-3,117,91.46915270669842,116,-13,353.60557762770594
271,113,104,-3,117,91.46915270669842,116,-13,353.60557762770594
272,113,104,-3,117,91.46915270669842,116,-13,353.60557762770594
273,113,104,-3,117,91.46915270669842,116,-13,353.60557762770594
274,113,104,-3,117,91.46915270669842,116,-13,353.60557762770594
275,113,104,-3,117,91.46915270669842,116,-13,353.60557762770594
276,113,104,-3,117,91.46915270669842,116,-13,353.60557762770594
277,113,104,-3,117,91.46915270669842,116,-13,353.60557762770594
278,113,104,-3,117,91.46915270669842,116,-13,353.60557762770594
279,113,104,-3,117,91.46915270669842,116,-13,353.60557762770594
280,113,104,-3,117,91.46915270669842,116,-13,353.60557762770594
281,113,104,-3,117,91.46915270669842,116,-13,353.60557762770594
282,113,104,-3,117,91.46915270669842,116,-13,353.60557762770594
283,113,104,-3,117,91.46915270669842,116,-13,353.60557762770594
284,113,104,-3,117,91.46915270669842,116,-13,353.60557762770594
285,113,104,-3,117,91.46915270669842,116,-13,353.60557762770594
286,113,104,-3,117,91.46915270669842,116,-13,353.60557762770594
287,113,104,-3,117,91.46915270669842,116,-13,353.60557762770594
288,113,104,-3,117,91.46915270669842,116,-13,353.60557762770594
289,113,104,-3,117,91.46915270669842,116,-13,353.60557762770594
290,113,104,-3,117,91.46915270669842,116,-13,353.60557762770594
291,113,104,-3,117,91.46915270669842,116,-13,353.60557762770594
292,113,104,-3,117,91.46915270669842,116,-13,353.60557762770594
293,113,104,-3,117,91.46915270669842,116,-13,353.60557762770594
294,113,104,-3,117,91.46915270669842,116,-13,353.60557762770594
295,113,104,-3,117,91.46915270669842,116,-13,353.60557762770594
296,113,104,-3,117,91.46915270669842,116,-13,353.60557762770594
297,113,104,-3,117,91.46915270669842,116,-13,353.60557762770594
298,113,104,-3,117,91.46915270669842,116,-13,353.60557762770594
299,113,104,-3,117,91.46915270669842,116,-13,353.60557762770594
300,113,104,-3,117,91.46915270669842,116,-13,353.60557762770594
301,113,104,-3,117,91.46915270669842,116,-13,353.60557762770594
302,113,104,-3,117,91.46915270669842,116,-13,353.60557762770594
303,113,104,-3,117,91.46915270669842,116,-13,353.60557762770594
304,113,104,-3,117,91.46915270669842,116,-13,353.60557762770594
305,113,104,-3,117,91.46915270669842,116,-13,353.60557762770594
306,113,104,-3,117,91.46915270669842,116,-13,353.60557762770594
307,113,104,-3,117,91.46915270669842,116,-13,353.60557762770594
308,113,104,-3,117,91.46915270669842,116,-13,353.60557762770594
309,113,104,-3,117,91.46915270669842,116,-13,353.60557762770594
310,113,104,-3,117,91.46915270669842,116,-13,353.60557762770594
311,113,104,-3,117,91.46915270669842,116,-13,353.60557762770594
312,113,104,-3,117,91.46915270669842,116,-13,353.60557762770594
313,113,104,-3,117,91.46915270669842,116,-13,353.60557762770594
314,113,104,-3,117,91.46915270669842,116,-13,353.60557762770594
315,113,104,-3,117,91.46915270669842,116,-13,353.60557762770594
316,113,104,-3,117,91.46915270669842,116,-13,353.60557762770594
317,113,104,-3,117,91.46915270669842,116,-13,353.60557762770594
318,113,104,-3,117,91.46915270669842,116,-13,353.60557762770594
319,113,104,-3,117,91.46915270669842,116,-13,353.60557762770594
320,113,104,-3,117,91.46915270669842,116,-13,353.60557762770594
321,113,104,-3,117,91.46915270669842,116,-13,353.60557762770594
322,113,104,-3,117,91.46915270669842,116,-13,353.60557762770594
323,113,104,-3,117,91.46915270669842,116,-13,353.60557762770594
324,113,104,-3,117,91.46915270669842,116,-13,353.60557762770594
325,113,104,-3,117,91.46915270669842,116,-13,353.60557762770594
326,113,104,-3,117,91.46915270669842,116,-13,353.60557762770594
327,113,104,-3,117,91.46915270669842,116,-13,353.60557762770594
328,113,104,-3,117,91.46915270669842,116,-13,353.60557762770594
329,113,104,-3,117,91.46915270669842,116,-13,353.60557762770594
330,113,104,-3,117,91.46915270669842,116,-13,353.60557762770594
331,113,104,-3,117,91.46915270669842,116,-13,353.60557762770594
332,113,104,-3,117,91.46915270669842,116,-13,353.60557762770594
333,113,104,-3,117,91.46915270669842,116,-13,353.60557762770594
334,113,104,-3,117,91.46915270669842,116,-13,353.60557762770594
335,113,104,-3,117,91.46915270669842,116,-13,353.60557762770594
336,113,104,-3,117,91.46915270669842,116,-13,353.60557762770594
337,113,104,-3,117,91.46915270669842,116,-13,353.60557762770594
338,114,103,-2,117,90.97966976301998,116,-14,353.11824988695815
339,114,103,-2,117,90.97966976301998,116,-14,353.11824988695815
340,116,99,0,117,90.0003463400404,116,-18,351.1795865051944
341,117,97,2,117,89.02102291706082,115,-20,350.1341550910937
342,118,93,3,117,88.53153997338237,115,-24,348.2117713373382
343,119,91,5,117,87.55328828092873,114,-26,347.15224570045325
344,120,87,7,117,86.57646191929076,113,-30,345.1316614250444
345,122,85,9,117,85.6016240578472,113,-32,344.1885682241855
346,123,82,11,116,84.58330338027648,112,-34,343.1131438919235
347,125,77,15,116,82.63226691451705,110,-39,340.47819460011476
348,125,72,17,116,81.66286981685096,108,-44,337.833568876883
349,126,70,18,116,81.17993284523479,108,-46,336.9294989700919
350,127,67,20,115,80.13450143113408,107,-48,335.83899190009436
351,127,64,22,115,79.17022512007577,105,-51,334.0933923064742
352,127,61,23,115,78.69037034288164,104,-54,332.5601664576175
353,128,58,25,114,77.63123721521191,103,-56,331.4674369937694
354,128,55,27,114,76.67576380238633,101,-59,329.70818733049106
355,128,54,27,114,76.67576380238633,101,-60,329.28705409504124
356,128,54,27,114,76.67576380238633,101,-60,329.28705409504124
357,128,54,27,114,76.67576380238633,101,-60,329.28705409504124
358,128,54,27,114,76.67576380238633,101,-60,329.28705409504124
359,128,54,27,114,76.67576380238633,101,-60,329.28705409504124
360,128,54,27,114,76.67576380238633,101,-60,329.28705409504124
361,128,54,27,114,76.67576380238633,101,-60,329.28705409504124
362,128,54,27,114,76.67576380238633,101,-60,329.28705409504124
363,128,52,28,113,76.08341535149587,100,-61,328.6166881741336
364,128,48,31,113,74.65939654087185,97,-65,326.17370807121216
365,128,39,36,111,72.03113745063246,92,-72,321.9528110546823
366,128,35,39,110,70.47854094015516,89,-75,319.8791193895185
367,128,30,42,109,68.92753862754552,86,-79,317.42910950186445
368,128,23,47,107,66.28666019850603,81,-84,313.9581961455584
369,128,12,55,103,61.89888689382144,73,-91,308.7363121123387
370,128,9,57,102,60.80274793554818,71,-93,307.35939066696653
371,128,4,61,100,58.61703451417405,67,-96,304.9116182250661
372,128,-1,65,97,56.17405441125257,63,-98,302.7350059045071
373,128,-8,70,94,53.325855539403385,58,-102,299.62351640991494
374,128,-15,75,89,49.879465729558916,53,-104,297.00384828047333
375,128,-20,79,86,47.42945584190484,49,-106,294.8091575075469
376,128,-25,83,83,45.0001731700202,45,-108,292.61960565427717
377,127,-29,85,80,43.264461901714064,42,-109,291.0724613724545
378,126,-33,88,78,41.55277305184276,38,-111,288.8979732998856
379,124,-38,91,74,39.11770494296437,33,-112,286.416949667562
380,122,-43,93,70,36.96848616793539,29,-113,284.39330201820087
381,120,-46,95,68,35.59482547533036,25,-114,282.3687627847881
382,118,-49,97,66,34.23198717069434,21,-115,280.3483775719958
383,118,-50,97,65,33.82629192878782,21,-115,280.3483775719958
384,118,-50,97,65,33.82629192878782,21,-115,280.3483775719958
385,118,-50,97,65,33.82629192878782,21,-115,280.3483775719958
386,118,-50,97,65,33.82629192878782,21,-115,280.3483775719958
387,118,-50,97,65,33.82629192878782,21,-115,280.3483775719958
388,118,-50,97,65,33.82629192878782,21,-115,280.3483775719958
389,118,-50,97,65,33.82629192878782,21,-115,280.3483775719958
390,118,-50,97,65,33.82629192878782,21,-115,280.3483775719958
391,118,-50,97,65,33.82629192878782,21,-115,280.3483775719958
392,118,-50,97,65,33.82629192878782,21,-115,280.3483775719958
393,118,-50,97,65,33.82629192878782,21,-115,280.3483775719958
394,118,-50,97,65,33.82629192878782,21,-115,280.3483775719958
395,118,-50,97,65,33.82629192878782,21,-115,280.3483775719958
396,118,-50,97,65,33.82629192878782,21,-115,280.3483775719958
397,118,-50,97,65,33.82629192878782,21,-115,280.3483775719958
398,118,-50,97,65,33.82629192878782,21,-115,280.3483775719958
399,118,-50,97,65,33.82629192878782,21,-115,280.3483775719958
400,118,-50,97,65,33.82629192878782,21,-115,280.3483775719958
401,118,-50,97,65,33.82629192878782,21,-115,280.3483775719958
402,118,-50,97,65,33.82629192878782,21,-115,280.3483775719958
403,118,-50,97,65,33.82629192878782,21,-115,280.3483775719958
404,118,-50,97,65,33.82629192878782,21,-115,280.3483775719958
405,118,-50,97,65,33.82629192878782,21,-115,280.3483775719958
406,118,-50,97,65,33.82629192878782,21,-115,280.3483775719958
407,118,-50,97,65,33.82629192878782,21,-115,280.3483775719958
408,118,-50,97,65,33.82629192878782,21,-115,280.3483775719958
409,118,-50,97,65,33.82629192878782,21,-115,280.3483775719958
410,118,-50,97,65,33.82629192878782,21,-115,280.3483775719958
411,118,-50,97,65,33.82629192878782,21,-115,280.3483775719958
412,118,-50,97,65,33.82629192878782,21,-115,280.3483775719958
413,118,-50,97,65,33.82629192878782,21,-115,280.3483775719958
414,118,-50,97,65,33.82629192878782,21,-115,280.3483775719958
415,118,-50,97,65,33.82629192878782,21,-115,280.3483775719958
416,118,-50,97,65,33.82629192878782,21,-115,280.3483775719958
417,118,-50,97,65,33.82629192878782,21,-115,280.3483775719958
418,118,-50,97,65,33.82629192878782,21,-115,280.3483775719958
419,118,-50,97,65,33.82629192878782,21,-115,280.3483775719958
420,118,-50,97,65,33.82629192878782,21,-115,280.3483775719958
421,118,-50,97,65,33.82629192878782,21,-115,280.3483775719958
422,118,-50,97,65,33.82629192878782,21,-115,280.3483775719958
423,118,-50,97,65,33.82629192878782,21,-115,280.3483775719958
424,118,-50,97,65,33.82629192878782,21,-115,280.3483775719958
425,118,-50,97,65,33.82629192878782,21,-115,280.3483775719958
426,118,-50,97,65,33.82629192878782,21,-115,280.3483775719958
427,118,-50,97,65,33.82629192878782,21,-115,280.3483775719958
428,118,-50,97,65,33.82629192878782,21,-115,280.3483775719958
429,118,-50,97,65,33.82629192878782,21,-115,280.3483775719958
430,118,-50,97,65,33.82629192878782,21,-115,280.3483775719958
431,118,-50,97,65,33.82629192878782,21,-115,280.3483775719958
432,118,-50,97,65,33.82629192878782,21,-115,280.3483775719958
433,118,-50,97,65,33.82629192878782,21,-115,280.3483775719958
434,118,-50,97,65,33.82629192878782,21,-115,280.3483775719958
435,118,-50,97,65,33.82629192878782,21,-115,280.3483775719958
436,118,-50,97,65,33.82629192878782,21,-115,280.3483775719958
437,118,-50,97,65,33.82629192878782,21,-115,280.3483775719958
438,118,-50,97,65,33.82629192878782,21,-115,280.3483775719958
439,118,-50,97,65,33.82629192878782,21,-115,280.3483775719958
440,118,-50,97,65,33.82629192878782,21,-115,280.3483775719958
441,118,-50,97,65,33.82629192878782,21,-115,280.3483775719958
442,118,-50,97,65,33.82629192878782,21,-115,280.3483775719958
443,118,-50,97,65,33.82629192878782,21,-115,280.3483775719958
444,118,-50,97,65,33.82629192878782,21,-115,280.3483775719958
445,118,-50,97,65,33.82629192878782,21,-115,280.3483775719958
446,118,-50,97,65,33.82629192878782,21,-115,280.3483775719958
447,118,-50,97,65,33.82629192878782,21,-115,280.3483775719958
448,118,-50,97,65,33.82629192878782,21,-115,280.3483775719958
449,118,-50,97,65,33.82629192878782,21,-115,280.3483775719958
450,118,-50,97,65,33.82629192878782,21,-115,280.3483775719958
451,118,-50,97,65,33.82629192878782,21,-115,280.3483775719958
452,118,-50,97,65,33.82629192878782,21,-115,280.3483775719958
453,118,-50,97,65,33.82629192878782,21,-115,280.3483775719958
454,118,-50,97,65,33.82629192878782,21,-115,280.3483775719958
455,118,-50,97,65,33.82629192878782,21,-115,280.3483775719958
456,118,-50,97,65,33.82629192878782,21,-115,280.3483775719958
457,118,-50,97,65,33.82629192878782,21,-115,280.3483775719958
458,118,-50,97,65,33.82629192878782,21,-115,280.3483775719958
459,118,-50,97,65,33.82629192878782,21,-115,280.3483775719958
460,118,-50,97,65,33.82629192878782,21,-115,280.3483775719958
461,118,-50,97,65,33.82629192878782,21,-115,280.3483775719958
462,118,-50,97,65,33.82629192878782,21,-115,280.3483775719958
463,118,-50,97,65,33.82629192878782,21,-115,280.3483775719958
464,118,-50,97,65,33.82629192878782,21,-115,280.3483775719958
465,118,-50,97,65,33.82629192878782,21,-115,280.3483775719958
466,118,-50,97,65,33.82629192878782,21,-115,280.3483775719958
467,118,-50,97,65,33.82629192878782,21,-115,280.3483775719958
468,118,-50,97,65,33.82629192878782,21,-115,280.3483775719958
469,118,-50,97,65,33.82629192878782,21,-115,280.3483775719958
470,118,-50,97,65,33.82629192878782,21,-115,280.3483775719958
471,118,-50,97,65,33.82629192878782,21,-115,280.3483775719958
472,117,-51,98,64,33.14712338927684,19,-115,279.38119992284794
473,115,-54,99,62,32.057499098125504,16,-116,277.8529971832361
474,111,-60,102,57,29.197598404492215,9,-117,274.3983759421528
475,102,-69,107,48,24.161008099905626,-5,-117,267.5525956008479
476,95,-75,110,41,20.441875223001514,-15,-116,262.63157423443624
477,89,-81,112,34,16.88685610807649,-23,-115,258.6896776628008
478,83,-85,114,28,13.799538499511918,-31,-113,254.6587038607911
479,79,-87,114,25,12.369109124828487,-35,-112,252.64556224154722
480,76,-88,115,22,10.830121219964632,-39,-110,250.47784826007438
481,72,-91,116,18,8.820413494805617,-44,-109,248.0171308635239
482,68,-92,116,15,7.368079425523356,-48,-107,245.83864556005398
483,65,-94,116,11,5.4170429597639185,-51,-105,244.0930459664338
484,60,-96,117,6,2.9356847435462843,-57,-102,240.8020552554674
485,54,-99,117,0,0.0,-63,-99,237.52833641273278
486,47,-102,117,-8,356.088413134872,-70,-94,233.32516285932257
487,43,-104,116,-13,353.60557762770594,-73,-91,231.26299520758053
488,38,-107,115,-19,350.6184537371117,-77,-88,228.81357000163902
489,35,-108,115,-22,349.1698787800354,-80,-86,227.0695191089194
490,34,-108,115,-23,348.69002400284126,-81,-85,226.3798398752937
491,34,-108,115,-23,348.69002400284126,-81,-85,226.3798398752937
492,34,-108,115,-23,348.69002400284126,-81,-85,226.3798398752937
493,34,-108,115,-23,348.69002400284126,-81,-85,226.3798398752937
494,34,-108,115,-23,348.69002400284126,-81,-85,226.3798398752937
495,34,-108,115,-23,348.69002400284126,-81,-85,226.3798398752937
496,34,-108,115,-23,348.69002400284126,-81,-85,226.3798398752937
497,31,-109,114,-26,347.15224570045325,-83,-83,224.9994804899394
498,20,-113,110,-39,340.47819460011476,-90,-74,219.4272612429177
499,7,-115,105,-51,334.0933923064742,-98,-64,213.14643070919604
500,-8,-117,97,-65,326.17370807121216,-105,-52,206.34577476425738
501,-22,-118,88,-77,318.8139163416794,-110,-41,200.44118254292073
502,-32,-118,80,-85,313.26411556167363,-112,-33,196.41660332752156
503,-42,-118,72,-92,308.04684260527733,-114,-26,192.84706161946596
504,-50,-118,65,-97,303.82594558874746,-115,-21,190.34803123195542
505,-55,-118,61,-100,301.38296548582593,-116,-18,188.81972081472483
506,-61,-117,55,-103,298.10111310617856,-116,-14,186.88105743296106
507,-68,-114,49,-106,294.8091575075469,-117,-8,183.9108941850472
508,-73,-113,44,-108,292.1660847830766,-117,-5,182.44636537903088
509,-78,-112,39,-110,289.52145905984486,-117,-2,180.9786307428988
510,-81,-112,36,-111,287.96886254936754,-117,-1,180.4890047975061
511,-82,-112,35,-112,287.35374507837196,-117,0,180.0006926800808
512,-82,-111,35,-112,287.35374507837196,-117,1,179.5109952024939
513,-82,-111,35,-112,287.35374507837196,-117,1,179.5109952024939
514,-82,-111,35,-112,287.35374507837196,-117,1,179.5109952024939
515,-82,-111,35,-112,287.35374507837196,-117,1,179.5109952024939
516,-82,-111,35,-112,287.35374507837196,-117,1,179.5109952024939
517,-82,-111,35,-112,287.35374507837196,-117,1,179.5109952024939
518,-82,-111,35,-112,287.35374507837196,-117,1,179.5109952024939
519,-82,-111,35,-112,287.35374507837196,-117,1,179.5109952024939
520,-82,-111,35,-112,287.35374507837196,-117,1,179.5109952024939
521,-82,-111,35,-112,287.35374507837196,-117,1,179.5109952024939
522,-82,-111,35,-112,287.35374507837196,-117,1,179.5109952024939
523,-82,-111,35,-112,287.35374507837196,-117,1,179.5109952024939
524,-82,-111,35,-112,287.35374507837196,-117,1,179.5109952024939
525,-82,-111,35,-112,287.35374507837196,-117,1,179.5109952024939
526,-82,-111,35,-112,287.35374507837196,-117,1,179.5109952024939
527,-82,-111,35,-112,287.35374507837196,-117,1,179.5109952024939
528,-82,-111,35,-112,287.35374507837196,-117,1,179.5109952024939
529,-82,-111,35,-112,287.35374507837196,-117,1,179.5109952024939
530,-82,-111,35,-112,287.35374507837196,-117,1,179.5109952024939
531,-82,-111,35,-112,287.35374507837196,-117,1,179.5109952024939
532,-82,-111,35,-112,287.35374507837196,-117,1,179.5109952024939
533,-82,-111,35,-112,287.35374507837196,-117,1,179.5109952024939
534,-82,-111,35,-112,287.35374507837196,-117,1,179.5109952024939
535,-82,-111,35,-112,287.35374507837196,-117,1,179.5109952024939
536,-82,-111,35,-112,287.35374507837196,-117,1,179.5109952024939
537,-82,-111,35,-112,287.35374507837196,-117,1,179.5109952024939
538,-82,-111,35,-112,287.35374507837196,-117,1,179.5109952024939
539,-82,-111,35,-112,287.35374507837196,-117,1,179.5109952024939
540,-82,-111,35,-112,287.35374507837196,-117,1,179.5109952024939
541,-82,-111,35,-112,287.35374507837196,-117,1,179.5109952024939
542,-82,-111,35,-112,287.35374507837196,-117,1,179.5109952024939
543,-82,-111,35,-112,287.35374507837196,-117,1,179.5109952024939
544,-82,-111,35,-112,287.35374507837196,-117,1,179.5109952024939
545,-82,-111,35,-112,287.35374507837196,-117,1,179.5109952024939
546,-82,-111,35,-112,287.35374507837196,-117,1,179.5109952024939
547,-82,-111,35,-112,287.35374507837196,-117,1,179.5109952024939
548,-82,-111,35,-112,287.35374507837196,-117,1,179.5109952024939
549,-82,-111,35,-112,287.35374507837196,-117,1,179.5109952024939
550,-82,-111,35,-112,287.35374507837196,-117,1,179.5109952024939
551,-82,-111,35,-112,287.35374507837196,-117,1,179.5109952024939
552,-82,-111,35,-112,287.35374507837196,-117,1,179.5109952024939
553,-82,-111,35,-112,287.35374507837196,-117,1,179.5109952024939
554,-82,-111,35,-112,287.35374507837196,-117,1,179.5109952024939
555,-82,-111,35,-112,287.35374507837196,-117,1,179.5109952024939
556,-82,-111,35,-112,287.35374507837196,-117,1,179.5109952024939
557,-82,-111,35,-112,287.35374507837196,-117,1,179.5109952024939
558,-82,-111,35,-112,287.35374507837196,-117,1,179.5109952024939
559,-82,-111,35,-112,287.35374507837196,-117,1,179.5109952024939
560,-82,-111,35,-112,287.35374507837196,-117,1,179.5109952024939
561,-82,-111,35,-112,287.35374507837196,-117,1,179.5109952024939
562,-82,-111,35,-112,287.35374507837196,-117,1,179.5109952024939
563,-82,-111,35,-112,287.35374507837196,-117,1,179.5109952024939
564,-82,-111,35,-112,287.35374507837196,-117,1,179.5109952024939
565,-82,-111,35,-112,287.35374507837196,-117,1,179.5109952024939
566,-82,-111,35,-112,287.35374507837196,-117,1,179.5109952024939
567,-82,-111,35,-112,287.35374507837196,-117,1,179.5109952024939
568,-82,-111,35,-112,287.35374507837196,-117,1,179.5109952024939
569,-82,-111,35,-112,287.35374507837196,-117,1,179.5109952024939
570,-82,-111,35,-112,287.35374507837196,-117,1,179.5109952024939
571,-82,-111,35,-112,287.35374507837196,-117,1,179.5109952024939
572,-84,-109,33,-112,286.416949667562,-117,3,178.53188631342277
573,-88,-105,29,-113,284.39330201820087,-117,8,176.0891058149528
574,-91,-102,25,-114,282.3687627847881,-116,12,174.09452883816417
575,-95,-98,21,-115,280.3483775719958,-116,17,171.66321615689137
576,-102,-89,12,-116,275.90581750187624,-114,27,166.67611014242672
577,-108,-84,4,-117,271.9577286242731,-112,33,163.58339667247844
578,-114,-79,-3,-117,268.5308472933016,-111,38,161.10237304015476
579,-119,-75,-10,-117,265.11443229249505,-109,42,158.92788496758592
580,-122,-73,-13,-116,263.60523128766556,-109,43,158.4716029498293
581,-123,-70,-15,-116,262.63157423443624,-108,46,156.93019165017267
582,-123,-70,-15,-116,262.63157423443624,-108,46,156.93019165017267
583,-123,-70,-15,-116,262.63157423443624,-108,46,156.93019165017267
584,-123,-70,-15,-116,262.63157423443624,-108,46,156.93019165017267
585,-123,-70,-15,-116,262.63157423443624,-108,46,156.93019165017267
586,-123,-70,-15,-116,262.63157423443624,-108,46,156.93019165017267
587,-123,-70,-15,-116,262.63157423443624,-108,46,156.93019165017267
588,-123,-70,-15,-116,262.63157423443624,-108,46,156.93019165017267
589,-126,-67,-19,-115,260.6181073970713,-107,48,155.83968458017517
590,-128,-62,-23,-115,258.6896776628008,-105,53,153.21768481132418
591,-132,-56,-30,-113,255.13131508500402,-102,57,150.8030942755886
592,-135,-50,-35,-111,252.49872504379567,-100,61,148.61738085421445
593,-136,-47,-38,-111,251.10133402003356,-98,64,146.85356929080396
594,-138,-43,-42,-109,248.92684594746476,-96,66,145.49203689593188
595,-141,-36,-48,-107,245.83864556005398,-93,71,142.64095567307385
596,-142,-28,-53,-104,242.9954590394459,-89,76,139.50544370955234
597,-142,-20,-58,-102,240.37579091000424,-84,82,135.69079936426604
598,-142,-14,-62,-99,237.9421545618341,-80,85,133.26480824175445
599,-142,-5,-68,-95,234.40482818462925,-74,90,129.4283002630389
600,-142,4,-74,-91,230.88194871699525,-68,95,125.59517181537076
601,-142,10,-78,-88,228.44688060811686,-64,98,123.14746972931722
602,-142,14,-80,-85,226.73519175824555,-62,99,122.05784543816591
603,-142,15,-81,-85,226.3798398752937,-61,100,121.38365816590672
604,-142,15,-81,-85,226.3798398752937,-61,100,121.38365816590672
605,-142,15,-81,-85,226.3798398752937,-61,100,121.38365816590672
606,-142,15,-81,-85,226.3798398752937,-61,100,121.38365816590672
607,-142,15,-81,-85,226.3798398752937,-61,100,121.38365816590672
608,-142,15,-81,-85,226.3798398752937,-61,100,121.38365816590672
609,-142,16,-81,-84,226.0411111743608,-61,100,121.38365816590672
610,-143,20,-84,-81,223.95784980551804,-59,101,120.29215900954932
611,-143,23,-86,-79,222.57019781805477,-57,102,119.1979447445326
612,-143,25,-87,-78,221.87733801317046,-56,103,118.53290934627098
613,-144,25,-88,-78,221.55208037176197,-56,103,118.53290934627098
614,-144,25,-88,-78,221.55208037176197,-56,103,118.53290934627098
615,-144,25,-88,-78,221.55208037176197,-56,103,118.53290934627098
616,-144,25,-88,-78,221.55208037176197,-56,103,118.53290934627098
617,-144,25,-88,-78,221.55208037176197,-56,103,118.53290934627098
618,-144,25,-88,-78,221.55208037176197,-56,103,118.53290934627098
619,-144,25,-88,-78,221.55208037176197,-56,103,118.53290934627098
620,-144,25,-88,-78,221.55208037176197,-56,103,118.53290934627098
621,-144,25,-88,-78,221.55208037176197,-56,103,118.53290934627098
622,-144,25,-88,-78,221.55208037176197,-56,103,118.53290934627098
623,-144,25,-88,-78,221.55208037176197,-56,103,118.53290934627098
624,-144,25,-88,-78,221.55208037176197,-56,103,118.53290934627098
625,-144,25,-88,-78,221.55208037176197,-56,103,118.53290934627098
626,-144,25,-88,-78,221.55208037176197,-56,103,118.53290934627098
627,-144,25,-88,-78,221.55208037176197,-56,103,118.53290934627098
628,-144,25,-88,-78,221.55208037176197,-56,103,118.53290934627098
629,-144,25,-88,-78,221.55208037176197,-56,103,118.53290934627098
630,-144,25,-88,-78,221.55208037176197,-56,103,118.53290934627098
631,-144,25,-88,-78,221.55208037176197,-56,103,118.53290934627098
632,-144,25,-88,-78,221.55208037176197,-56,103,118.53290934627098
633,-144,25,-88,-78,221.55208037176197,-56,103,118.53290934627098
634,-144,25,-88,-78,221.55208037176197,-56,103,118.53290934627098
635,-144,25,-88,-78,221.55208037176197,-56,103,118.53290934627098
636,-144,25,-88,-78,221.55208037176197,-56,103,118.53290934627098
637,-144,25,-88,-78,221.55208037176197,-56,103,118.53290934627098
638,-144,25,-88,-78,221.55208037176197,-56,103,118.53290934627098
639,-144,25,-88,-78,221.55208037176197,-56,103,118.53290934627098
640,-144,25,-88,-78,221.55208037176197,-56,103,118.53290934627098
641,-144,25,-88,-78,221.55208037176197,-56,103,118.53290934627098
642,-144,25,-88,-78,221.55208037176197,-56,103,118.53290934627098
643,-144,25,-88,-78,221.55208037176197,-56,103,118.53290934627098
644,-144,25,-88,-78,221.55208037176197,-56,103,118.53290934627098
645,-144,25,-88,-78,221.55208037176197,-56,103,118.53290934627098
646,-144,25,-88,-78,221.55208037176197,-56,103,118.53290934627098
647,-144,25,-88,-78,221.55208037176197,-56,103,118.53290934627098
648,-144,25,-88,-78,221.55208037176197,-56,103,118.53290934627098
649,-144,25,-88,-78,221.55208037176197,-56,103,118.53290934627098
650,-144,25,-88,-78,221.55208037176197,-56,103,118.53290934627098
651,-144,25,-88,-78,221.55208037176197,-56,103,118.53290934627098
652,-144,25,-88,-78,221.55208037176197,-56,103,118.53290934627098
653,-144,25,-88,-78,221.55208037176197,-56,103,118.53290934627098
654,-144,25,-88,-78,221.55208037176197,-56,103,118.53290934627098
655,-144,25,-88,-78,221.55208037176197,-56,103,118.53290934627098
